AK101_Black	database/weapons/firearms/AK101/objects.json
AK101_Green	database/weapons/firearms/AK101/objects.json
AK74_Black	database/weapons/firearms/AK101/objects.json
AK74_Green	database/weapons/firearms/AK101/objects.json
AKS74U_Black	database/weapons/firearms/AK74/objects.json
AKS74U_Green	database/weapons/firearms/AK74/objects.json
AK_FoldingBttstck_Black	database/weapons/attachments/support/objects.json
AK_FoldingBttstck_Green	database/weapons/attachments/support/objects.json
AK_PlasticBttstck_Black	database/weapons/attachments/support/objects.json
AK_PlasticBttstck_Green	database/weapons/attachments/support/objects.json
AK_RailHndgrd_Black	database/weapons/attachments/support/objects.json
AK_RailHndgrd_Green	database/weapons/attachments/support/objects.json
AK_WoodBttstck_Black	database/weapons/attachments/support/objects.json
AK_WoodBttstck_Camo	database/weapons/attachments/support/objects.json
AK_WoodHndgrd_Black	database/weapons/attachments/support/objects.json
AK_WoodHndgrd_Camo	database/weapons/attachments/support/objects.json
AlarmClock_Blue	UNMAPPED
AlarmClock_Green	UNMAPPED
AlarmClock_Red	UNMAPPED
Ammo_40mm_Chemgas	database/weapons/ammunition/objects.json
Animal_UrsusArctos	database/animals/capra_hircus/objects.json
Anniversary_FireworksLauncher	UNMAPPED
Bandana_Camopattern	database/characters/headgear/objects.json
Bandana_Polkapattern	database/characters/headgear/objects.json
Bandana_Redpattern	database/characters/headgear/objects.json
Breeches_Beetcheck	database/characters/pants/objects.json
Breeches_Beige	database/characters/pants/objects.json
Breeches_Black	database/characters/pants/objects.json
Breeches_Blackcheck	database/characters/pants/objects.json
Breeches_Blue	database/characters/pants/objects.json
Breeches_Browncheck	database/characters/pants/objects.json
Breeches_Green	database/characters/pants/objects.json
Breeches_Pink	database/characters/pants/objects.json
Breeches_Red	database/characters/pants/objects.json
Breeches_White	database/characters/pants/objects.json
Camonet	UNMAPPED
ChernarusMap_Open	database/gear/navigation/objects.json
CivSedanDoors_BackLeft_Black	database/vehicles/wheeled/civiliansedan/proxy/objects.json
CivSedanDoors_BackLeft_BlackRust	database/vehicles/wheeled/civiliansedan/proxy/objects.json
CivSedanDoors_BackLeft_WhiteRust	database/vehicles/wheeled/civiliansedan/proxy/objects.json
CivSedanDoors_BackLeft_Wine	database/vehicles/wheeled/civiliansedan/proxy/objects.json
CivSedanDoors_BackLeft_WineRust	database/vehicles/wheeled/civiliansedan/proxy/objects.json
CivSedanDoors_BackRight_Black	database/vehicles/wheeled/civiliansedan/proxy/objects.json
CivSedanDoors_BackRight_BlackRust	database/vehicles/wheeled/civiliansedan/proxy/objects.json
CivSedanDoors_BackRight_WhiteRust	database/vehicles/wheeled/civiliansedan/proxy/objects.json
CivSedanDoors_BackRight_Wine	database/vehicles/wheeled/civiliansedan/proxy/objects.json
CivSedanDoors_BackRight_WineRust	database/vehicles/wheeled/civiliansedan/proxy/objects.json
CivSedanDoors_CoDriver_Black	database/vehicles/wheeled/civiliansedan/proxy/objects.json
CivSedanDoors_CoDriver_BlackRust	database/vehicles/wheeled/civiliansedan/proxy/objects.json
CivSedanDoors_CoDriver_WhiteRust	database/vehicles/wheeled/civiliansedan/proxy/objects.json
CivSedanDoors_CoDriver_Wine	database/vehicles/wheeled/civiliansedan/proxy/objects.json
CivSedanDoors_CoDriver_WineRust	database/vehicles/wheeled/civiliansedan/proxy/objects.json
CivSedanDoors_Driver_Black	database/vehicles/wheeled/civiliansedan/proxy/objects.json
CivSedanDoors_Driver_BlackRust	database/vehicles/wheeled/civiliansedan/proxy/objects.json
CivSedanDoors_Driver_WhiteRust	database/vehicles/wheeled/civiliansedan/proxy/objects.json
CivSedanDoors_Driver_Wine	database/vehicles/wheeled/civiliansedan/proxy/objects.json
CivSedanDoors_Driver_WineRust	database/vehicles/wheeled/civiliansedan/proxy/objects.json
CivSedanHood_Black	database/vehicles/wheeled/civiliansedan/proxy/objects.json
CivSedanHood_BlackRust	database/vehicles/wheeled/civiliansedan/proxy/objects.json
CivSedanHood_WhiteRust	database/vehicles/wheeled/civiliansedan/proxy/objects.json
CivSedanHood_Wine	database/vehicles/wheeled/civiliansedan/proxy/objects.json
CivSedanHood_WineRust	database/vehicles/wheeled/civiliansedan/proxy/objects.json
CivSedanTrunk_Black	database/vehicles/wheeled/civiliansedan/proxy/objects.json
CivSedanTrunk_BlackRust	database/vehicles/wheeled/civiliansedan/proxy/objects.json
CivSedanTrunk_WhiteRust	database/vehicles/wheeled/civiliansedan/proxy/objects.json
CivSedanTrunk_Wine	database/vehicles/wheeled/civiliansedan/proxy/objects.json
CivSedanTrunk_WineRust	database/vehicles/wheeled/civiliansedan/proxy/objects.json
CivilianSedan_Black	database/vehicles/wheeled/civiliansedan/objects.json
CivilianSedan_Wine	database/vehicles/wheeled/civiliansedan/objects.json
ContaminatedArea_Dynamic	UNMAPPED
Crossbow_Autumn	UNMAPPED
Crossbow_Black	UNMAPPED
Crossbow_Summer	UNMAPPED
Crossbow_Wood	UNMAPPED
DarkMotoHelmet_Black	database/characters/headgear/objects.json
DarkMotoHelmet_Blue	database/characters/headgear/objects.json
DarkMotoHelmet_Green	database/characters/headgear/objects.json
DarkMotoHelmet_Grey	database/characters/headgear/objects.json
DarkMotoHelmet_Lime	database/characters/headgear/objects.json
DarkMotoHelmet_Red	database/characters/headgear/objects.json
Deagle_Gold	database/weapons/pistols/DE/objects.json
Derringer_Black	UNMAPPED
Derringer_Grey	UNMAPPED
Derringer_Pink	UNMAPPED
FirefighterAxe_Black	database/weapons/melee/blade/objects.json
FirefighterAxe_Green	database/weapons/melee/blade/objects.json
Flag_APA	database/gear/camping/objects.json
Flag_Altis	database/gear/camping/objects.json
Flag_BabyDeer	database/gear/camping/objects.json
Flag_Bear	database/gear/camping/objects.json
Flag_Bohemia	database/gear/camping/objects.json
Flag_BrainZ	database/gear/camping/objects.json
Flag_CDF	database/gear/camping/objects.json
Flag_CHEL	database/gear/camping/objects.json
Flag_CMC	database/gear/camping/objects.json
Flag_Cannibals	database/gear/camping/objects.json
Flag_Chedaki	database/gear/camping/objects.json
Flag_Chernarus	database/gear/camping/objects.json
Flag_Crook	database/gear/camping/objects.json
Flag_DayZ	database/gear/camping/objects.json
Flag_HunterZ	database/gear/camping/objects.json
Flag_Livonia	database/gear/camping/objects.json
Flag_LivoniaArmy	database/gear/camping/objects.json
Flag_LivoniaPolice	database/gear/camping/objects.json
Flag_NAPA	database/gear/camping/objects.json
Flag_NSahrani	database/gear/camping/objects.json
Flag_Pirates	database/gear/camping/objects.json
Flag_RSTA	database/gear/camping/objects.json
Flag_Refuge	database/gear/camping/objects.json
Flag_Rex	database/gear/camping/objects.json
Flag_Rooster	database/gear/camping/objects.json
Flag_SSahrani	database/gear/camping/objects.json
Flag_Snake	database/gear/camping/objects.json
Flag_TEC	database/gear/camping/objects.json
Flag_UEC	database/gear/camping/objects.json
Flag_White	database/gear/camping/objects.json
Flag_Wolf	database/gear/camping/objects.json
Flag_Zagorky	database/gear/camping/objects.json
Flag_Zenit	database/gear/camping/objects.json
Foxpelt	UNMAPPED
GiftBox_Large_1	database/gear/containers/objects.json
GiftBox_Large_2	database/gear/containers/objects.json
GiftBox_Large_3	database/gear/containers/objects.json
GiftBox_Large_4	database/gear/containers/objects.json
GiftBox_Medium_1	database/gear/containers/objects.json
GiftBox_Medium_2	database/gear/containers/objects.json
GiftBox_Medium_3	database/gear/containers/objects.json
GiftBox_Medium_4	database/gear/containers/objects.json
GiftBox_Small_1	database/gear/containers/objects.json
GiftBox_Small_2	database/gear/containers/objects.json
GiftBox_Small_3	database/gear/containers/objects.json
GiftBox_Small_4	database/gear/containers/objects.json
HatchbackDoors_CoDriver_Blue	database/vehicles/wheeled/OffroadHatchback/proxy/objects.json
HatchbackDoors_CoDriver_BlueRust	database/vehicles/wheeled/OffroadHatchback/proxy/objects.json
HatchbackDoors_CoDriver_GreenRust	database/vehicles/wheeled/OffroadHatchback/proxy/objects.json
HatchbackDoors_CoDriver_White	database/vehicles/wheeled/OffroadHatchback/proxy/objects.json
HatchbackDoors_CoDriver_WhiteRust	database/vehicles/wheeled/OffroadHatchback/proxy/objects.json
HatchbackDoors_Driver_Blue	database/vehicles/wheeled/OffroadHatchback/proxy/objects.json
HatchbackDoors_Driver_BlueRust	database/vehicles/wheeled/OffroadHatchback/proxy/objects.json
HatchbackDoors_Driver_GreenRust	database/vehicles/wheeled/OffroadHatchback/proxy/objects.json
HatchbackDoors_Driver_White	database/vehicles/wheeled/OffroadHatchback/proxy/objects.json
HatchbackDoors_Driver_WhiteRust	database/vehicles/wheeled/OffroadHatchback/proxy/objects.json
HatchbackHood_Blue	database/vehicles/wheeled/OffroadHatchback/proxy/objects.json
HatchbackHood_BlueRust	database/vehicles/wheeled/OffroadHatchback/proxy/objects.json
HatchbackHood_GreenRust	database/vehicles/wheeled/OffroadHatchback/proxy/objects.json
HatchbackHood_White	database/vehicles/wheeled/OffroadHatchback/proxy/objects.json
HatchbackHood_WhiteRust	database/vehicles/wheeled/OffroadHatchback/proxy/objects.json
HatchbackTrunk_Blue	database/vehicles/wheeled/OffroadHatchback/proxy/objects.json
HatchbackTrunk_BlueRust	database/vehicles/wheeled/OffroadHatchback/proxy/objects.json
HatchbackTrunk_GreenRust	database/vehicles/wheeled/OffroadHatchback/proxy/objects.json
HatchbackTrunk_White	database/vehicles/wheeled/OffroadHatchback/proxy/objects.json
HatchbackTrunk_WhiteRust	database/vehicles/wheeled/OffroadHatchback/proxy/objects.json
Hatchback_02_Black	database/vehicles/wheeled/Hatchback_02/objects.json
Hatchback_02_Blue	database/vehicles/wheeled/Hatchback_02/objects.json
Hatchback_02_Door_1_1_Black	database/vehicles/wheeled/Hatchback_02/Proxy/objects.json
Hatchback_02_Door_1_1_BlackRust	database/vehicles/wheeled/Hatchback_02/Proxy/objects.json
Hatchback_02_Door_1_1_Blue	database/vehicles/wheeled/Hatchback_02/Proxy/objects.json
Hatchback_02_Door_1_1_BlueRust	database/vehicles/wheeled/Hatchback_02/Proxy/objects.json
Hatchback_02_Door_1_1_RedRust	database/vehicles/wheeled/Hatchback_02/Proxy/objects.json
Hatchback_02_Door_1_2_Black	database/vehicles/wheeled/Hatchback_02/Proxy/objects.json
Hatchback_02_Door_1_2_BlackRust	database/vehicles/wheeled/Hatchback_02/Proxy/objects.json
Hatchback_02_Door_1_2_Blue	database/vehicles/wheeled/Hatchback_02/Proxy/objects.json
Hatchback_02_Door_1_2_BlueRust	database/vehicles/wheeled/Hatchback_02/Proxy/objects.json
Hatchback_02_Door_1_2_RedRust	database/vehicles/wheeled/Hatchback_02/Proxy/objects.json
Hatchback_02_Door_2_1_Black	database/vehicles/wheeled/Hatchback_02/Proxy/objects.json
Hatchback_02_Door_2_1_BlackRust	database/vehicles/wheeled/Hatchback_02/Proxy/objects.json
Hatchback_02_Door_2_1_Blue	database/vehicles/wheeled/Hatchback_02/Proxy/objects.json
Hatchback_02_Door_2_1_BlueRust	database/vehicles/wheeled/Hatchback_02/Proxy/objects.json
Hatchback_02_Door_2_1_RedRust	database/vehicles/wheeled/Hatchback_02/Proxy/objects.json
Hatchback_02_Door_2_2_Black	database/vehicles/wheeled/Hatchback_02/Proxy/objects.json
Hatchback_02_Door_2_2_BlackRust	database/vehicles/wheeled/Hatchback_02/Proxy/objects.json
Hatchback_02_Door_2_2_Blue	database/vehicles/wheeled/Hatchback_02/Proxy/objects.json
Hatchback_02_Door_2_2_BlueRust	database/vehicles/wheeled/Hatchback_02/Proxy/objects.json
Hatchback_02_Door_2_2_RedRust	database/vehicles/wheeled/Hatchback_02/Proxy/objects.json
Hatchback_02_Hood_Black	database/vehicles/wheeled/Hatchback_02/Proxy/objects.json
Hatchback_02_Hood_BlackRust	database/vehicles/wheeled/Hatchback_02/Proxy/objects.json
Hatchback_02_Hood_Blue	database/vehicles/wheeled/Hatchback_02/Proxy/objects.json
Hatchback_02_Hood_BlueRust	database/vehicles/wheeled/Hatchback_02/Proxy/objects.json
Hatchback_02_Hood_RedRust	database/vehicles/wheeled/Hatchback_02/Proxy/objects.json
Hatchback_02_Trunk_Black	database/vehicles/wheeled/Hatchback_02/Proxy/objects.json
Hatchback_02_Trunk_BlackRust	database/vehicles/wheeled/Hatchback_02/Proxy/objects.json
Hatchback_02_Trunk_Blue	database/vehicles/wheeled/Hatchback_02/Proxy/objects.json
Hatchback_02_Trunk_BlueRust	database/vehicles/wheeled/Hatchback_02/Proxy/objects.json
Hatchback_02_Trunk_RedRust	database/vehicles/wheeled/Hatchback_02/Proxy/objects.json
HuntingVest_Winter	database/characters/vests/objects.json
Land_Wreck_Ikarus_DE	database/structures/wrecks/Vehicles/objects.json
Land_Wreck_S1023_Medic_Beige_DE	database/structures/wrecks/Vehicles/objects.json
Land_Wreck_Tractor_DE	database/structures/wrecks/Vehicles/objects.json
Land_Wreck_Trailer_Closed_DE	database/structures/wrecks/Vehicles/objects.json
Land_Wreck_V3S_DE	database/structures/wrecks/Vehicles/objects.json
Land_Wreck_sed02_aban1_Police_DE	database/structures/wrecks/Vehicles/objects.json
Land_Wreck_sed02_aban2_Police_DE	database/structures/wrecks/Vehicles/objects.json
Land_wreck_truck01_aban1_orange_DE	database/structures/wrecks/Vehicles/objects.json
LeatherBelt_Natural	database/characters/belts/objects.json
Longhorn	UNMAPPED
M16A2	UNMAPPED
M4A1_Black	database/weapons/firearms/M4/objects.json
M4A1_Green	database/weapons/firearms/M4/objects.json
M4_RISHndgrd_Black	database/weapons/attachments/support/objects.json
M4_RISHndgrd_Green	database/weapons/attachments/support/objects.json
MK4Optic_Black	database/weapons/attachments/optics/objects.json
MK4Optic_Green	database/weapons/attachments/optics/objects.json
MK4Optic_Tan	database/weapons/attachments/optics/objects.json
MK4Optic_black	database/weapons/attachments/optics/objects.json
MK4Optic_green	database/weapons/attachments/optics/objects.json
MK4Optic_tan	database/weapons/attachments/optics/objects.json
Mag_CZ550_10Rnd	database/weapons/attachments/magazine/objects.json
MediumTent_Green	database/gear/camping/objects.json
MediumTent_Orange	database/gear/camping/objects.json
MimeMask_Female	database/characters/masks/objects.json
Mosin9130_Black	database/weapons/firearms/mosin9130/objects.json
Mosin9130_Camo	database/weapons/firearms/mosin9130/objects.json
Mosin9130_Green	database/weapons/firearms/mosin9130/objects.json
MotoHelmet_White	database/characters/headgear/objects.json
MotoHelmet_Yellow	database/characters/headgear/objects.json
NBCBootsGray	database/characters/shoes/objects.json
NBCBootsWhite	database/characters/shoes/objects.json
NBCBootsYellow	database/characters/shoes/objects.json
NBCHoodGray	UNMAPPED
NBCHoodWhite	UNMAPPED
NBCHoodYellow	UNMAPPED
NBCJacketGray	database/characters/tops/objects.json
NBCJacketWhite	database/characters/tops/objects.json
NBCJacketYellow	database/characters/tops/objects.json
NBCPantsGray	database/characters/pants/objects.json
NBCPantsWhite	database/characters/pants/objects.json
NBCPantsYellow	database/characters/pants/objects.json
NavyUniformPants	database/characters/pants/objects.json
OKZKCap_Beige	UNMAPPED
OKZKCap_Green	UNMAPPED
OffroadHatchback_Blue	database/vehicles/wheeled/OffroadHatchback/objects.json
OffroadHatchback_White	database/vehicles/wheeled/OffroadHatchback/objects.json
Offroad_02_Door_1_1_Rust	database/vehicles/wheeled/Offroad_02/proxy/objects.json
Offroad_02_Door_1_2_Rust	database/vehicles/wheeled/Offroad_02/proxy/objects.json
Offroad_02_Door_2_1_Rust	database/vehicles/wheeled/Offroad_02/proxy/objects.json
Offroad_02_Door_2_2_Rust	database/vehicles/wheeled/Offroad_02/proxy/objects.json
Offroad_02_Trunk_Rust	database/vehicles/wheeled/Offroad_02/proxy/objects.json
PM73Rak	UNMAPPED
PP19	database/weapons/attachments/support/objects.json
PartyTent_Blue	database/gear/camping/objects.json
PartyTent_Brown	database/gear/camping/objects.json
PartyTent_Lunapark	database/gear/camping/objects.json
PetushokHat_Black	UNMAPPED
PetushokHat_Green	UNMAPPED
PetushokHat_Yellow	UNMAPPED
PlateCarrierHolster_Black	database/characters/vests/objects.json
PlateCarrierHolster_Camo	database/characters/vests/objects.json
PlateCarrierHolster_Green	database/characters/vests/objects.json
PlateCarrierHolster_Winter	database/characters/vests/objects.json
PlateCarrierPouches_Black	database/characters/vests/objects.json
PlateCarrierPouches_Camo	database/characters/vests/objects.json
PlateCarrierPouches_Green	database/characters/vests/objects.json
PlateCarrierPouches_Winter	database/characters/vests/objects.json
PlateCarrierVest_Black	database/characters/vests/objects.json
PlateCarrierVest_Camo	database/characters/vests/objects.json
PlateCarrierVest_Green	database/characters/vests/objects.json
PlateCarrierVest_Winter	database/characters/vests/objects.json
SawedoffMosin9130_Black	database/weapons/firearms/mosin9130/objects.json
SawedoffMosin9130_Camo	database/weapons/firearms/mosin9130/objects.json
SawedoffMosin9130_Green	database/weapons/firearms/mosin9130/objects.json
Scout_Chernarus	database/weapons/firearms/scout/objects.json
Scout_Livonia	database/weapons/firearms/scout/objects.json
Sedan_02_Door_1_1_Grey	database/vehicles/wheeled/Sedan_02/proxy/objects.json
Sedan_02_Door_1_1_GreyRust	database/vehicles/wheeled/Sedan_02/proxy/objects.json
Sedan_02_Door_1_1_Red	database/vehicles/wheeled/Sedan_02/proxy/objects.json
Sedan_02_Door_1_1_RedRust	database/vehicles/wheeled/Sedan_02/proxy/objects.json
Sedan_02_Door_1_1_YellowRust	database/vehicles/wheeled/Sedan_02/proxy/objects.json
Sedan_02_Door_1_2_Grey	database/vehicles/wheeled/Sedan_02/proxy/objects.json
Sedan_02_Door_1_2_GreyRust	database/vehicles/wheeled/Sedan_02/proxy/objects.json
Sedan_02_Door_1_2_Red	database/vehicles/wheeled/Sedan_02/proxy/objects.json
Sedan_02_Door_1_2_RedRust	database/vehicles/wheeled/Sedan_02/proxy/objects.json
Sedan_02_Door_1_2_YellowRust	database/vehicles/wheeled/Sedan_02/proxy/objects.json
Sedan_02_Door_2_1_Grey	database/vehicles/wheeled/Sedan_02/proxy/objects.json
Sedan_02_Door_2_1_GreyRust	database/vehicles/wheeled/Sedan_02/proxy/objects.json
Sedan_02_Door_2_1_Red	database/vehicles/wheeled/Sedan_02/proxy/objects.json
Sedan_02_Door_2_1_RedRust	database/vehicles/wheeled/Sedan_02/proxy/objects.json
Sedan_02_Door_2_1_YellowRust	database/vehicles/wheeled/Sedan_02/proxy/objects.json
Sedan_02_Door_2_2_Grey	database/vehicles/wheeled/Sedan_02/proxy/objects.json
Sedan_02_Door_2_2_GreyRust	database/vehicles/wheeled/Sedan_02/proxy/objects.json
Sedan_02_Door_2_2_Red	database/vehicles/wheeled/Sedan_02/proxy/objects.json
Sedan_02_Door_2_2_RedRust	database/vehicles/wheeled/Sedan_02/proxy/objects.json
Sedan_02_Door_2_2_YellowRust	database/vehicles/wheeled/Sedan_02/proxy/objects.json
Sedan_02_Grey	database/vehicles/wheeled/Sedan_02/objects.json
Sedan_02_Hood_Grey	database/vehicles/wheeled/Sedan_02/proxy/objects.json
Sedan_02_Hood_GreyRust	database/vehicles/wheeled/Sedan_02/proxy/objects.json
Sedan_02_Hood_Red	database/vehicles/wheeled/Sedan_02/proxy/objects.json
Sedan_02_Hood_RedRust	database/vehicles/wheeled/Sedan_02/proxy/objects.json
Sedan_02_Hood_YellowRust	database/vehicles/wheeled/Sedan_02/proxy/objects.json
Sedan_02_Red	database/vehicles/wheeled/Sedan_02/objects.json
Sedan_02_Trunk_Grey	database/vehicles/wheeled/Sedan_02/proxy/objects.json
Sedan_02_Trunk_GreyRust	database/vehicles/wheeled/Sedan_02/proxy/objects.json
Sedan_02_Trunk_Red	database/vehicles/wheeled/Sedan_02/proxy/objects.json
Sedan_02_Trunk_RedRust	database/vehicles/wheeled/Sedan_02/proxy/objects.json
Sedan_02_Trunk_YellowRust	database/vehicles/wheeled/Sedan_02/proxy/objects.json
ShippingContainerKeys_Blue	UNMAPPED
ShippingContainerKeys_Orange	UNMAPPED
ShippingContainerKeys_Red	UNMAPPED
ShippingContainerKeys_Yellow	UNMAPPED
ShortJeans_Black	UNMAPPED
ShortJeans_Blue	UNMAPPED
ShortJeans_Brown	UNMAPPED
ShortJeans_Darkblue	UNMAPPED
ShortJeans_Green	UNMAPPED
ShortJeans_Red	UNMAPPED
Skirt_Blue	UNMAPPED
Skirt_Red	UNMAPPED
Skirt_White	UNMAPPED
Skirt_Yellow	UNMAPPED
SlacksPants_Beige	database/characters/pants/objects.json
SlacksPants_Black	database/characters/pants/objects.json
SlacksPants_Blue	database/characters/pants/objects.json
SlacksPants_Brown	database/characters/pants/objects.json
SlacksPants_DarkGrey	database/characters/pants/objects.json
SlacksPants_Khaki	database/characters/pants/objects.json
SlacksPants_LightGrey	database/characters/pants/objects.json
SlacksPants_White	database/characters/pants/objects.json
Slingbag_Black	database/characters/backpacks/objects.json
Slingbag_Brown	database/characters/backpacks/objects.json
Slingbag_Gray	database/characters/backpacks/objects.json
SpearBone	UNMAPPED
SpearStone	UNMAPPED
Static_FrozenScientist_DE	UNMAPPED
SurgicalGloves_Blue	database/characters/gloves/objects.json
SurgicalGloves_Green	database/characters/gloves/objects.json
SurgicalGloves_LightBlue	database/characters/gloves/objects.json
SurgicalGloves_White	database/characters/gloves/objects.json
Sweater_ChristmasBlue	database/characters/tops/objects.json
Sweater_ChristmasGreen	database/characters/tops/objects.json
Sweater_ChristmasRed	database/characters/tops/objects.json
Truck_01_Covered_Blue	database/vehicles/wheeled/Truck_01/objects.json
Truck_01_Covered_Orange	database/vehicles/wheeled/Truck_01/objects.json
Truck_01_Door_1_1_Blue	database/vehicles/wheeled/Truck_01/proxy/objects.json
Truck_01_Door_1_1_BlueRust	database/vehicles/wheeled/Truck_01/proxy/objects.json
Truck_01_Door_1_1_GreenRust	database/vehicles/wheeled/Truck_01/proxy/objects.json
Truck_01_Door_1_1_Orange	database/vehicles/wheeled/Truck_01/proxy/objects.json
Truck_01_Door_1_1_OrangeRust	database/vehicles/wheeled/Truck_01/proxy/objects.json
Truck_01_Door_2_1_Blue	database/vehicles/wheeled/Truck_01/proxy/objects.json
Truck_01_Door_2_1_BlueRust	database/vehicles/wheeled/Truck_01/proxy/objects.json
Truck_01_Door_2_1_GreenRust	database/vehicles/wheeled/Truck_01/proxy/objects.json
Truck_01_Door_2_1_Orange	database/vehicles/wheeled/Truck_01/proxy/objects.json
Truck_01_Door_2_1_OrangeRust	database/vehicles/wheeled/Truck_01/proxy/objects.json
Truck_01_Hood_Blue	database/vehicles/wheeled/Truck_01/proxy/objects.json
Truck_01_Hood_BlueRust	database/vehicles/wheeled/Truck_01/proxy/objects.json
Truck_01_Hood_GreenRust	database/vehicles/wheeled/Truck_01/proxy/objects.json
Truck_01_Hood_Orange	database/vehicles/wheeled/Truck_01/proxy/objects.json
Truck_01_Hood_OrangeRust	database/vehicles/wheeled/Truck_01/proxy/objects.json
Tshirt_10thAnniversary	UNMAPPED
WitchHoodCoif_Black	UNMAPPED
WitchHoodCoif_Brown	UNMAPPED
WitchHoodCoif_Red	UNMAPPED
WitchHood_Chainmail_Black	database/characters/headgear/objects.json
WitchHood_Chainmail_Brown	database/characters/headgear/objects.json
WitchHood_Chainmail_Red	database/characters/headgear/objects.json
WoolGlovesFingerless_Black	database/characters/gloves/objects.json
WoolGlovesFingerless_ChristmasBlue	database/characters/gloves/objects.json
WoolGlovesFingerless_ChristmasRed	database/characters/gloves/objects.json
WoolGlovesFingerless_Green	database/characters/gloves/objects.json
WoolGlovesFingerless_Tan	database/characters/gloves/objects.json
WoolGlovesFingerless_White	database/characters/gloves/objects.json
ZmbF_BlueCollarFat_Blue	database/characters/zombies/objects.json
ZmbF_BlueCollarFat_Green	database/characters/zombies/objects.json
ZmbF_BlueCollarFat_Red	database/characters/zombies/objects.json
ZmbF_BlueCollarFat_White	database/characters/zombies/objects.json
ZmbF_CitizenANormal_Beige	database/characters/zombies/objects.json
ZmbF_CitizenANormal_Blue	database/characters/zombies/objects.json
ZmbF_CitizenANormal_Brown	database/characters/zombies/objects.json
ZmbF_CitizenBSkinny	database/characters/zombies/objects.json
ZmbF_Clerk_Normal_Blue	database/characters/zombies/objects.json
ZmbF_Clerk_Normal_Green	database/characters/zombies/objects.json
ZmbF_Clerk_Normal_Red	database/characters/zombies/objects.json
ZmbF_Clerk_Normal_White	database/characters/zombies/objects.json
ZmbF_DoctorSkinny	database/characters/zombies/objects.json
ZmbF_HikerSkinny_Blue	database/characters/zombies/objects.json
ZmbF_HikerSkinny_Green	database/characters/zombies/objects.json
ZmbF_HikerSkinny_Grey	database/characters/zombies/objects.json
ZmbF_HikerSkinny_Red	database/characters/zombies/objects.json
ZmbF_JoggerSkinny_Blue	database/characters/zombies/objects.json
ZmbF_JoggerSkinny_Brown	database/characters/zombies/objects.json
ZmbF_JoggerSkinny_Green	database/characters/zombies/objects.json
ZmbF_JoggerSkinny_Red	database/characters/zombies/objects.json
ZmbF_JournalistNormal_Blue	database/characters/zombies/objects.json
ZmbF_JournalistNormal_Green	database/characters/zombies/objects.json
ZmbF_JournalistNormal_Red	database/characters/zombies/objects.json
ZmbF_JournalistNormal_White	database/characters/zombies/objects.json
ZmbF_MechanicNormal_Beige	database/characters/zombies/objects.json
ZmbF_MechanicNormal_Green	database/characters/zombies/objects.json
ZmbF_MechanicNormal_Grey	database/characters/zombies/objects.json
ZmbF_MechanicNormal_Orange	database/characters/zombies/objects.json
ZmbF_MilkMaidOld_Beige	database/characters/zombies/objects.json
ZmbF_MilkMaidOld_Black	database/characters/zombies/objects.json
ZmbF_MilkMaidOld_Green	database/characters/zombies/objects.json
ZmbF_MilkMaidOld_Grey	database/characters/zombies/objects.json
ZmbF_NurseFat	database/characters/zombies/objects.json
ZmbF_NurseFat_Winter	database/characters/zombies/objects.json
ZmbF_ParamedicNormal_Blue	database/characters/zombies/objects.json
ZmbF_ParamedicNormal_Green	database/characters/zombies/objects.json
ZmbF_ParamedicNormal_Red	database/characters/zombies/objects.json
ZmbF_PatientOld	database/characters/zombies/objects.json
ZmbF_PatientOld_Winter	database/characters/zombies/objects.json
ZmbF_PoliceWomanNormal	database/characters/zombies/objects.json
ZmbF_ShortSkirt_beige	database/characters/zombies/objects.json
ZmbF_ShortSkirt_black	database/characters/zombies/objects.json
ZmbF_ShortSkirt_brown	database/characters/zombies/objects.json
ZmbF_ShortSkirt_checks	database/characters/zombies/objects.json
ZmbF_ShortSkirt_green	database/characters/zombies/objects.json
ZmbF_ShortSkirt_grey	database/characters/zombies/objects.json
ZmbF_ShortSkirt_red	database/characters/zombies/objects.json
ZmbF_ShortSkirt_stripes	database/characters/zombies/objects.json
ZmbF_ShortSkirt_white	database/characters/zombies/objects.json
ZmbF_ShortSkirt_yellow	database/characters/zombies/objects.json
ZmbF_SkaterYoung_Brown	database/characters/zombies/objects.json
ZmbF_SkaterYoung_Striped	database/characters/zombies/objects.json
ZmbF_SkaterYoung_Violet	database/characters/zombies/objects.json
ZmbF_SurvivorNormal_Blue	database/characters/zombies/objects.json
ZmbF_SurvivorNormal_Orange	database/characters/zombies/objects.json
ZmbF_SurvivorNormal_Red	database/characters/zombies/objects.json
ZmbF_SurvivorNormal_White	database/characters/zombies/objects.json
ZmbF_VillagerOld_Blue	database/characters/zombies/objects.json
ZmbF_VillagerOld_Green	database/characters/zombies/objects.json
ZmbF_VillagerOld_Red	database/characters/zombies/objects.json
ZmbF_VillagerOld_White	database/characters/zombies/objects.json
ZmbM_CitizenASkinny_Blue	database/characters/zombies/objects.json
ZmbM_CitizenASkinny_Brown	database/characters/zombies/objects.json
ZmbM_CitizenASkinny_Grey	database/characters/zombies/objects.json
ZmbM_CitizenASkinny_Red	database/characters/zombies/objects.json
ZmbM_CitizenBFat_Blue	database/characters/zombies/objects.json
ZmbM_CitizenBFat_Green	database/characters/zombies/objects.json
ZmbM_CitizenBFat_Red	database/characters/zombies/objects.json
ZmbM_ClerkFat_Brown	database/characters/zombies/objects.json
ZmbM_ClerkFat_Grey	database/characters/zombies/objects.json
ZmbM_ClerkFat_Khaki	database/characters/zombies/objects.json
ZmbM_ClerkFat_White	database/characters/zombies/objects.json
ZmbM_CommercialPilotOld_Blue	database/characters/zombies/objects.json
ZmbM_CommercialPilotOld_Brown	database/characters/zombies/objects.json
ZmbM_CommercialPilotOld_Grey	database/characters/zombies/objects.json
ZmbM_CommercialPilotOld_Olive	database/characters/zombies/objects.json
ZmbM_ConstrWorkerNormal_Beige	database/characters/zombies/objects.json
ZmbM_ConstrWorkerNormal_Black	database/characters/zombies/objects.json
ZmbM_ConstrWorkerNormal_Green	database/characters/zombies/objects.json
ZmbM_ConstrWorkerNormal_Grey	database/characters/zombies/objects.json
ZmbM_DoctorFat	database/characters/zombies/objects.json
ZmbM_DoctorFat_Winter	database/characters/zombies/objects.json
ZmbM_FarmerFat_Beige	database/characters/zombies/objects.json
ZmbM_FarmerFat_Blue	database/characters/zombies/objects.json
ZmbM_FarmerFat_Brown	database/characters/zombies/objects.json
ZmbM_FarmerFat_Green	database/characters/zombies/objects.json
ZmbM_FirefighterNormal	database/characters/zombies/objects.json
ZmbM_FishermanOld_Blue	database/characters/zombies/objects.json
ZmbM_FishermanOld_Green	database/characters/zombies/objects.json
ZmbM_FishermanOld_Grey	database/characters/zombies/objects.json
ZmbM_FishermanOld_Red	database/characters/zombies/objects.json
ZmbM_Gamedev_Black	database/characters/zombies/objects.json
ZmbM_Gamedev_Blue	database/characters/zombies/objects.json
ZmbM_Gamedev_Gray	database/characters/zombies/objects.json
ZmbM_HandymanNormal_Beige	database/characters/zombies/objects.json
ZmbM_HandymanNormal_Blue	database/characters/zombies/objects.json
ZmbM_HandymanNormal_Green	database/characters/zombies/objects.json
ZmbM_HandymanNormal_Grey	database/characters/zombies/objects.json
ZmbM_HandymanNormal_White	database/characters/zombies/objects.json
ZmbM_HeavyIndustryWorker	database/characters/zombies/objects.json
ZmbM_HermitSkinny_Beige	database/characters/zombies/objects.json
ZmbM_HermitSkinny_Black	database/characters/zombies/objects.json
ZmbM_HermitSkinny_Green	database/characters/zombies/objects.json
ZmbM_HermitSkinny_Red	database/characters/zombies/objects.json
ZmbM_HikerSkinny_Blue	database/characters/zombies/objects.json
ZmbM_HikerSkinny_Green	database/characters/zombies/objects.json
ZmbM_HikerSkinny_Yellow	database/characters/zombies/objects.json
ZmbM_HunterOld_Autumn	database/characters/zombies/objects.json
ZmbM_HunterOld_Spring	database/characters/zombies/objects.json
ZmbM_HunterOld_Summer	database/characters/zombies/objects.json
ZmbM_HunterOld_Winter	database/characters/zombies/objects.json
ZmbM_Jacket_beige	database/characters/zombies/objects.json
ZmbM_Jacket_black	database/characters/zombies/objects.json
ZmbM_Jacket_blue	database/characters/zombies/objects.json
ZmbM_Jacket_bluechecks	database/characters/zombies/objects.json
ZmbM_Jacket_brown	database/characters/zombies/objects.json
ZmbM_Jacket_greenchecks	database/characters/zombies/objects.json
ZmbM_Jacket_grey	database/characters/zombies/objects.json
ZmbM_Jacket_khaki	database/characters/zombies/objects.json
ZmbM_Jacket_magenta	database/characters/zombies/objects.json
ZmbM_Jacket_stripes	database/characters/zombies/objects.json
ZmbM_JoggerSkinny_Blue	database/characters/zombies/objects.json
ZmbM_JoggerSkinny_Green	database/characters/zombies/objects.json
ZmbM_JoggerSkinny_Red	database/characters/zombies/objects.json
ZmbM_JournalistSkinny	database/characters/zombies/objects.json
ZmbM_MechanicSkinny_Blue	database/characters/zombies/objects.json
ZmbM_MechanicSkinny_Green	database/characters/zombies/objects.json
ZmbM_MechanicSkinny_Grey	database/characters/zombies/objects.json
ZmbM_MechanicSkinny_Red	database/characters/zombies/objects.json
ZmbM_MotobikerFat_Beige	database/characters/zombies/objects.json
ZmbM_MotobikerFat_Black	database/characters/zombies/objects.json
ZmbM_MotobikerFat_Blue	database/characters/zombies/objects.json
ZmbM_OffshoreWorker_Green	database/characters/zombies/objects.json
ZmbM_OffshoreWorker_Orange	database/characters/zombies/objects.json
ZmbM_OffshoreWorker_Red	database/characters/zombies/objects.json
ZmbM_OffshoreWorker_Yellow	database/characters/zombies/objects.json
ZmbM_ParamedicNormal_Black	database/characters/zombies/objects.json
ZmbM_ParamedicNormal_Blue	database/characters/zombies/objects.json
ZmbM_ParamedicNormal_Green	database/characters/zombies/objects.json
ZmbM_ParamedicNormal_Red	database/characters/zombies/objects.json
ZmbM_PatientSkinny	database/characters/zombies/objects.json
ZmbM_PatientSkinny_Winter	database/characters/zombies/objects.json
ZmbM_PatrolNormal_Autumn	database/characters/zombies/objects.json
ZmbM_PatrolNormal_Flat	database/characters/zombies/objects.json
ZmbM_PatrolNormal_PautRev	database/characters/zombies/objects.json
ZmbM_PatrolNormal_Summer	database/characters/zombies/objects.json
ZmbM_PolicemanFat	database/characters/zombies/objects.json
ZmbM_PolicemanSpecForce	database/characters/zombies/objects.json
ZmbM_PolicemanSpecForce_Heavy	database/characters/zombies/objects.json
ZmbM_PrisonerSkinny	database/characters/zombies/objects.json
ZmbM_SkaterYoung_Blue	database/characters/zombies/objects.json
ZmbM_SkaterYoung_Brown	database/characters/zombies/objects.json
ZmbM_SkaterYoung_Green	database/characters/zombies/objects.json
ZmbM_SkaterYoung_Grey	database/characters/zombies/objects.json
ZmbM_SoldierNormal	database/characters/zombies/objects.json
ZmbM_VillagerOld_Blue	database/characters/zombies/objects.json
ZmbM_VillagerOld_Green	database/characters/zombies/objects.json
ZmbM_VillagerOld_White	database/characters/zombies/objects.json
ZmbM_eastSoldier_Heavy_Navy	database/characters/zombies/objects.json
ZmbM_eastSoldier_normal_Navy	database/characters/zombies/objects.json
ZmbM_priestPopSkinny	database/characters/zombies/objects.json
ZmbM_usSoldier_Heavy_Woodland	database/characters/zombies/objects.json
ZmbM_usSoldier_Officer_Convoy	database/characters/zombies/objects.json
ZmbM_usSoldier_normal_Desert	database/characters/zombies/objects.json
ZmbM_usSoldier_normal_Woodland	database/characters/zombies/objects.json
Zmbm_Mummy	UNMAPPED
m14	UNMAPPED
